Stage 2
  #######
###  O  ###
#    o    #
# Oo P oO #
###  o  ###
 #   O  # 
 ########
=====
Stage 1
#####
#OoP#
#####