Stage 1
######
#  P #
#o####
# #
#O#
###
=====
Stage 2
######
#P   #
#  oO# 
# Oo # 
######